4
10 10 255 100 100 8 4 1 5
1	1	1	1	1	1	1	1	1	1
1	0	0	0	1	3	0	0	0	1
1	0	1	0	1	0	1	1	0	1
1	0	1	0	1	0	0	0	0	1
1	0	1	0	1	1	1	0	0	1
1	0	1	0	1	0	1	1	0	1
1	0	1	0	0	0	0	1	0	1
1	0	1	1	1	1	0	1	0	1
1	0	0	0	2	1	0	0	0	1
1	1	1	1	1	1	1	1	1	1
10 10 100 255 100 1 5 8 1
1	1	1	1	1	1	1	1	1	1
1	0	0	1	1	2	0	0	0	1
1	0	1	0	1	1	1	1	0	1
1	0	0	0	1	0	1	0	0	1
1	0	1	0	0	0	1	0	0	1
1	0	1	0	1	0	1	1	0	1
1	0	1	0	1	0	0	1	0	1
1	0	1	0	0	1	0	1	0	1
1	3	1	0	0	1	0	0	0	1
1	1	1	1	1	1	1	1	1	1
20 20 255 128 0 14 10 14 3
0	0	0	1	0	1	0	0	0	0	0	0	0	0	0	0	0	0	1	0
0	1	0	0	0	0	1	1	1	1	1	0	0	1	0	0	1	0	0	0
0	1	1	1	0	0	0	0	0	1	0	0	1	0	0	1	0	0	1	0
0	1	0	1	0	1	0	0	1	0	1	0	1	1	1	1	0	1	0	0
0	1	0	0	0	0	1	0	0	0	0	0	0	0	0	0	1	0	0	0
0	1	1	1	1	1	0	1	0	1	1	1	1	1	1	1	1	1	1	0
0	1	0	0	0	1	0	0	0	0	0	1	0	0	0	0	0	1	0	0
0	1	1	1	0	1	1	0	0	0	1	0	1	1	1	0	1	0	0	0
0	1	0	0	0	0	0	1	0	1	0	0	0	0	0	0	0	1	1	0
0	1	0	1	1	0	1	0	0	0	1	0	0	1	1	1	0	1	0	0
0	1	0	1	0	0	0	1	0	0	1	0	1	0	0	0	0	1	0	0
0	1	0	1	0	1	0	1	1	0	1	0	0	1	0	0	1	0	0	0
0	1	0	0	1	0	0	0	1	0	1	0	1	0	0	1	1	0	0	1
0	1	1	1	1	1	0	1	0	0	1	0	0	1	0	0	0	0	1	0
0	0	1	3	1	0	0	0	0	1	2	0	1	0	1	1	1	1	0	0
0	1	0	0	1	0	0	0	0	0	1	1	0	0	0	0	0	0	1	0
1	0	0	1	1	0	1	0	0	0	0	0	0	1	0	0	1	1	0	0
0	1	0	1	0	1	0	0	1	0	1	1	0	0	1	0	1	0	0	0
0	1	0	0	0	0	0	0	1	0	0	0	1	1	0	1	0	0	1	0
0	0	0	1	1	1	1	1	1	0	1	0	0	0	0	0	0	0	1	0
27 33 248 241 7 12 0 14 31
1	1	1	1	1	1	1	1	1	1	1	1	1	1	1	1	1	1	1	1	1	1	1	1	1	1	1	1	1	1	1	1	1
1	0	0	0	0	0	0	0	0	0	0	0	0	0	1	0	0	0	0	0	0	0	0	0	0	0	0	0	0	0	0	0	1
1	0	1	1	1	1	1	1	1	1	1	1	1	0	1	0	1	1	1	1	1	1	1	1	1	1	1	0	1	1	1	0	1
1	0	1	0	0	0	0	0	0	0	1	0	0	0	1	0	1	0	0	0	0	0	0	1	0	1	0	0	1	0	0	0	1
1	0	1	0	1	1	1	1	1	0	1	1	1	1	1	0	1	1	1	1	0	1	0	1	0	1	0	1	1	0	1	1	1
1	0	1	0	0	0	0	0	1	0	0	0	0	0	0	0	0	0	0	0	0	1	0	0	0	1	0	0	1	0	0	0	1
1	0	1	1	1	1	1	0	1	1	1	1	1	1	1	0	1	1	1	1	0	1	1	1	0	1	1	0	1	1	1	0	1
1	0	0	0	0	0	1	0	0	0	0	0	0	0	0	0	0	0	0	1	0	0	0	1	0	1	0	0	1	0	1	0	1
1	1	1	0	1	1	1	1	1	1	1	1	1	1	1	1	1	1	0	1	0	1	0	0	0	1	0	1	1	0	0	0	1
1	0	0	0	0	0	0	0	0	0	0	0	0	1	0	1	0	1	0	1	0	1	0	1	0	1	0	0	1	0	1	1	1
1	0	1	1	1	1	1	1	0	1	1	1	0	1	0	1	0	1	0	1	1	1	1	1	1	1	1	0	1	0	1	0	1
1	0	0	0	0	0	0	1	0	1	0	1	0	1	0	0	0	1	0	1	0	0	0	0	1	0	0	0	1	0	1	0	1
2	0	1	1	1	1	0	1	0	1	0	1	0	1	0	1	1	1	0	1	0	1	1	0	1	0	1	1	1	0	0	0	1
1	0	0	0	0	1	0	1	0	0	0	1	0	0	0	1	0	1	0	1	0	0	1	0	0	0	1	0	1	0	1	1	1
1	0	1	1	0	1	0	1	1	1	1	1	1	1	0	1	0	1	0	1	1	1	1	0	1	1	1	0	1	0	1	3	1
1	0	1	0	0	1	0	1	0	0	0	0	0	1	0	0	0	1	0	0	0	0	1	0	0	0	1	0	0	0	1	0	1
1	0	1	1	1	1	0	1	0	1	1	1	0	1	1	1	1	1	0	1	1	0	1	1	1	0	1	1	1	1	1	0	1
1	0	0	0	0	0	0	1	0	0	0	1	0	1	0	0	0	1	0	1	0	0	1	0	0	0	0	0	0	0	1	0	1
1	1	1	1	0	1	1	1	1	1	0	1	0	1	0	1	0	1	0	1	1	1	1	0	1	1	1	1	1	0	1	0	1
1	0	0	0	0	0	0	0	0	0	0	1	0	1	0	1	0	1	0	0	0	0	1	0	1	0	0	0	0	0	1	0	1
1	0	1	1	1	1	1	1	0	1	1	1	0	1	0	1	1	1	0	1	1	0	1	0	1	0	1	1	1	1	1	0	1
1	0	1	0	0	0	0	0	0	1	0	0	0	1	0	0	0	0	0	1	0	0	1	0	1	0	0	0	1	0	1	0	1
1	0	1	0	1	1	1	1	0	1	0	1	0	1	0	1	1	1	1	1	1	1	1	0	1	1	1	0	1	0	1	0	1
1	0	0	0	1	0	0	1	0	0	0	1	0	1	0	1	0	0	0	0	0	1	0	0	1	0	1	0	0	0	1	0	1
1	0	1	1	1	0	1	1	1	1	1	1	1	1	0	1	1	1	1	1	0	1	0	1	1	0	1	1	1	0	1	0	1
1	0	0	0	0	0	0	0	0	0	0	0	0	0	0	0	0	0	0	0	0	1	0	0	0	0	1	0	0	0	0	0	1
1	1	1	1	1	1	1	1	1	1	1	1	1	1	1	1	1	1	1	1	1	1	1	1	1	1	1	1	1	1	1	1	1


